[console_scripts]
assistant = qt5_applications.entrypoints:assistant
canbusutil = qt5_applications.entrypoints:canbusutil
designer = qt5_applications.entrypoints:designer
lconvert = qt5_applications.entrypoints:lconvert
licheck64 = qt5_applications.entrypoints:licheck64
linguist = qt5_applications.entrypoints:linguist
lprodump = qt5_applications.entrypoints:lprodump
lrelease = qt5_applications.entrypoints:lrelease
lrelease-pro = qt5_applications.entrypoints:lrelease_pro
lupdate = qt5_applications.entrypoints:lupdate
lupdate-pro = qt5_applications.entrypoints:lupdate_pro
moc = qt5_applications.entrypoints:moc
pixeltool = qt5_applications.entrypoints:pixeltool
qcollectiongenerator = qt5_applications.entrypoints:qcollectiongenerator
qdbus = qt5_applications.entrypoints:qdbus
qdbuscpp2xml = qt5_applications.entrypoints:qdbuscpp2xml
qdbusviewer = qt5_applications.entrypoints:qdbusviewer
qdbusxml2cpp = qt5_applications.entrypoints:qdbusxml2cpp
qdistancefieldgenerator = qt5_applications.entrypoints:qdistancefieldgenerator
qdoc = qt5_applications.entrypoints:qdoc
qgltf = qt5_applications.entrypoints:qgltf
qhelpgenerator = qt5_applications.entrypoints:qhelpgenerator
qlalr = qt5_applications.entrypoints:qlalr
qmake = qt5_applications.entrypoints:qmake
qml = qt5_applications.entrypoints:qml
qmlcachegen = qt5_applications.entrypoints:qmlcachegen
qmleasing = qt5_applications.entrypoints:qmleasing
qmlimportscanner = qt5_applications.entrypoints:qmlimportscanner
qmllint = qt5_applications.entrypoints:qmllint
qmlmin = qt5_applications.entrypoints:qmlmin
qmlplugindump = qt5_applications.entrypoints:qmlplugindump
qmlpreview = qt5_applications.entrypoints:qmlpreview
qmlprofiler = qt5_applications.entrypoints:qmlprofiler
qmlscene = qt5_applications.entrypoints:qmlscene
qmltestrunner = qt5_applications.entrypoints:qmltestrunner
qscxmlc = qt5_applications.entrypoints:qscxmlc
qtattributionsscanner = qt5_applications.entrypoints:qtattributionsscanner
qtdiag = qt5_applications.entrypoints:qtdiag
qtpaths = qt5_applications.entrypoints:qtpaths
qtplugininfo = qt5_applications.entrypoints:qtplugininfo
qtwaylandscanner = qt5_applications.entrypoints:qtwaylandscanner
qvkgen = qt5_applications.entrypoints:qvkgen
rcc = qt5_applications.entrypoints:rcc
repc = qt5_applications.entrypoints:repc
sdpscanner = qt5_applications.entrypoints:sdpscanner
tracegen = qt5_applications.entrypoints:tracegen
uic = qt5_applications.entrypoints:uic
xmlpatterns = qt5_applications.entrypoints:xmlpatterns
xmlpatternsvalidator = qt5_applications.entrypoints:xmlpatternsvalidator

