[console_scripts]
convert-annotations = wai.annotations.main:sys_main

[wai.annotations.plugins]
check-duplicate-filenames = wai.annotations.isp.duplicate_filenames.specifier:DuplicateFileNamesISPSpecifier
coerce-box = wai.annotations.isp.coercions.specifier:BoxBoundsCoercionISPSpecifier
coerce-mask = wai.annotations.isp.coercions.specifier:MaskBoundsCoercionISPSpecifier
convert-image-format = wai.annotations.isp.convert_image_format.specifier:ConvertImageFormatISPSpecifier
dimension-discarder = wai.annotations.isp.dimension_discarder.specifier:DimensionDiscarderISPSpecifier
discard-negatives = wai.annotations.isp.discard_negatives.specifier:DiscardNegativesISPSpecifier
filter-labels = wai.annotations.isp.filter_labels.specifier:FilterLabelsISPSpecifier
from-adams-ic = wai.annotations.format.adams.ic.specifier:ADAMSICInputFormatSpecifier
from-adams-od = wai.annotations.format.adams.od.specifier:ADAMSODInputFormatSpecifier
from-blue-channel-is = wai.annotations.format.blue_channel.specifier:BlueChannelInputFormatSpecifier
from-coco-od = wai.annotations.format.coco.specifier:COCOInputFormatSpecifier
from-common-voice-sp = wai.annotations.format.common_voice.specifier:CommonVoiceInputFormatSpecifier
from-festvox-sp = wai.annotations.format.festvox.specifier:FestVoxInputFormatSpecifier
from-indexed-png-is = wai.annotations.format.indexed_png.specifier:IndexedPNGInputFormatSpecifier
from-roi-od = wai.annotations.format.roi.specifier:ROIInputFormatSpecifier
from-subdir-ic = wai.annotations.format.subdir.specifier:SubDirInputFormatSpecifier
from-tf-od = wai.annotations.format.tf.specifier:TFRecordsInputFormatSpecifier
from-vgg-od = wai.annotations.format.vgg.specifier:VGGInputFormatSpecifier
map-labels = wai.annotations.isp.map_labels.specifier:MapLabelsISPSpecifier
passthrough = wai.annotations.isp.passthrough.specifier:PassThroughISPSpecifier
remove-classes = wai.annotations.isp.remove_classes.specifier:RemoveClassesISPSpecifier
strip-annotations = wai.annotations.isp.strip_annotations.specifier:StripAnnotationsISPSpecifier
to-adams-ic = wai.annotations.format.adams.ic.specifier:ADAMSICOutputFormatSpecifier
to-adams-od = wai.annotations.format.adams.od.specifier:ADAMSODOutputFormatSpecifier
to-blue-channel-is = wai.annotations.format.blue_channel.specifier:BlueChannelOutputFormatSpecifier
to-coco-od = wai.annotations.format.coco.specifier:COCOOutputFormatSpecifier
to-common-voice-sp = wai.annotations.format.common_voice.specifier:CommonVoiceOutputFormatSpecifier
to-festvox-sp = wai.annotations.format.festvox.specifier:FestVoxOutputFormatSpecifier
to-indexed-png-is = wai.annotations.format.indexed_png.specifier:IndexedPNGOutputFormatSpecifier
to-roi-od = wai.annotations.format.roi.specifier:ROIOutputFormatSpecifier
to-subdir-ic = wai.annotations.format.subdir.specifier:SubDirOutputFormatSpecifier
to-tf-od = wai.annotations.format.tf.specifier:TFRecordsOutputFormatSpecifier
to-vgg-od = wai.annotations.format.vgg.specifier:VGGOutputFormatSpecifier

