[console_scripts]
esctl = esctl.main:main

[esctl]
cat allocation = esctl.cmd.cat:CatAllocation
cat plugins = esctl.cmd.cat:CatPlugins
cat thread-pool = esctl.cmd.cat:CatThreadpool
cluster allocation explain = esctl.cmd.cluster:ClusterAllocationExplain
cluster health = esctl.cmd.cluster:ClusterHealth
cluster info = esctl.cmd.cluster:ClusterInfo
cluster routing allocation enable = esctl.cmd.cluster:ClusterRoutingAllocationEnable
cluster settings get = esctl.cmd.settings:ClusterSettingsGet
cluster settings list = esctl.cmd.settings:ClusterSettingsList
cluster settings reset = esctl.cmd.settings:ClusterSettingsReset
cluster settings set = esctl.cmd.settings:ClusterSettingsSet
cluster stats = esctl.cmd.cluster:ClusterStats
config cluster list = esctl.cmd.config:ConfigClusterList
config context list = esctl.cmd.config:ConfigContextList
config context set = esctl.cmd.config:ConfigContextSet
config user list = esctl.cmd.config:ConfigUserList
index close = esctl.cmd.index:IndexClose
index create = esctl.cmd.index:IndexCreate
index delete = esctl.cmd.index:IndexDelete
index list = esctl.cmd.index:IndexList
index open = esctl.cmd.index:IndexOpen
index settings get = esctl.cmd.settings:IndexSettingsGet
index settings list = esctl.cmd.settings:IndexSettingsList
index settings set = esctl.cmd.settings:IndexSettingsSet
logging get = esctl.cmd.logging:LoggingGet
logging reset = esctl.cmd.logging:LoggingReset
logging set = esctl.cmd.logging:LoggingSet
node exclude = esctl.cmd.node:NodeExclude
node hot-threads = esctl.cmd.node:NodeHotThreads
node list = esctl.cmd.node:NodeList
repository list = esctl.cmd.repository:RepositoryList
repository show = esctl.cmd.repository:RepositoryShow
repository verify = esctl.cmd.repository:RepositoryVerify
roles get = esctl.cmd.roles:SecurityRolesGet
snapshot list = esctl.cmd.snapshot:SnapshotList
task list = esctl.cmd.task:TaskList
users get = esctl.cmd.users:SecurityUsersGet

